###################
#.....#.....#.....#
#.....#.....#.....#
#.....#.....#.....#
#.....#.....#.....#
#.....#.....#.....#
#.................#
#.....#.....#.....#
#.....#.....#.....#
#.....#.....#.....#
#.....#.....#.....#
#.....#.....#.....#
###.#####.#####.###
#.....#.....#.....#
#.....#.....#.....#
#.....#.....#.....#
#.....#.....#.....#
#.....#.....#.....#
#.................#
#.....#.....#.....#
#.....#.....#.....#
#.....#.....#.....#
#.....#.....#.....#
#.....#.....#.....#
###################
